 
 

C 173,216,230




F 51, 25, 0

NO ./assets/texture/NO.xpm





SO ./assets/texture/SO1.xpm


WE ./assets/texture/WE.xpm


EA ./assets/texture/EA.xpm


1111111111
1000000001
1000E00001
1000000001
1111111111
